100
5
13
1,0,0,0,0,0,0,0,0,0,0,1,
n
n
1,1,1,0,1,0,0,1,0,1,1,1,
n
0,1,0,1,0,1,1,0,1,0,1,0,
n
n
n
0,0,0,1,1,0,0,1,1,0,0,0,
n
0,0,1,0,0,0,0,0,0,1,0,0,
0,1,0,0,0,0,0,0,0,0,1,0,
